WWWWWWWWWWWWWWWWWWWWWWWWWWWWWWWWWWWWWWWWWWWWWWWWWWWWWWWWWWWWWWWWWWWWWWWWWWWWWWWWWWWWWWWWWWWWWWWWWWWWWWWWWWWWWWWWWWWWWWWWWWWWWWWWWWWWWWWWWWWWWWWWWWWWWWWWWWWWWWWWWWWWWWWWWWWWWWWWWWWWWWWWWWWWWWWWWWW
W........WWWWWWWWWWWWWWWWW.....WWWWWWWWWWWW.....WWWWWWWWWWWWWW.....WWWWW................................E............WWWWWWWWW........MMMM.........WWWWWWWWWWwwwwwwwwwwwwwwwwwwwwwwwwwwwwwwwwwwwwwW
W........E..WWWWWW..MMMM........E...............E...........E........E..............E..M.......MMMMMMMMMMMMMMMMMMMMMMMMMWWWWWW....E.MMMMMMMM..............WWWWWWWWWWWWWWWWWWWWWWWWWWWWWWWWWWWWWWWWW
W............WWWWW........MMMMMMMMMMMMMMMMMMMMMMMMMMMMMMMMMMMMMMMMMMMMMMMMWWWWWWWWWWWWWWWWWWWWWWWWWWWWWWWWWWWW........E.............MMMMMMMME................C..E..........E....E...E.......E.....W
W............WWWWW......E..MM....MMMMM.E.....R............E.........E...WWW....WWWWW......MMMMMM..................................MMM......................E.........E......E.............E....E..W
W.............WWWW.....WWWWWWWWWWMMMMMWWWWWWWWWWWWWW....WWWWWWWWWWWWWWWWW........WWW......MMMM........E..................WWWWWWWWWWWWWWWWWWWWWWWW.............E..........E.......E.......E........W
Wp......MMMMMM.WWW.....WWWWWWWWWWMMMMMWWWWWWWWWWWWWWMMMMMMMMMMMMMMMMMMMMMMMMMMMMMWWW.......MMM....................E...WWWWWW..............................MMMM......E.......E........E.....E......W
W.......WW.MM..WWW.....WWWWwwwwwwwwwwwwwwwwwwwwwwwwW..............E..............WWW.......WWW...E.........WWWWWWWWWWWWWW........E......E..............WWWWWWWWWWWWWWWWWWWWWWWWWWWWWWWWWWWWWWWWWWWW
W......WWW.....WWW......WWWwwwwwwwwwwwwwwwwwwwwwwwwWWWWWWWWWWWWWWWWWWWWWW........WWW.......WWW.............WWWWWWWWWWWWWW..........E.........E......WWWWWWWWWWwwwwwwwwwwwwwwwwwwwwwwwwwwwwwwwwwwwwW
W.....WWWW.MMMMMMMMMM...WWWwwwwwwwwwwwEwwwwwwwwMMMMMMMMMMMMwwwwwwwwwwwwWWW...E...WWW...E...WWW..wwwwwwwwwwwwwwwwwwwwwwwwww...........E............WWWWWWWWWWWWwwwwwwwwwwwwwwwwwwwwwwwwwwwwwwwwwwwwW
W.....WWWW.......E....E.WWWwwwwwwwwwwwwwwwwwwwwwwwwwwwwwwwwwwwwwwwwwwwwMMMMMMMMMMMM........WWW..........E......................RM.........E...WWWWWWWWWWWWWWWWwwwwwwwwwwwwwwwwwwwwwwwwwwwwwwwwwwwwW
W...WWWWWWWWWWWWWWWWWWWWWWWWWWWWwwwwwwwwwwwwwwwwwwwwwwwwwwwwEwwwwwwwwwwMMMMMMMMMMMM..w.....WWW....MMMMMMMMMMMMM..www......M...WWWWWWWWWWWWWWWWWWWWWWWWWWWWWWWWwwwwwwwwwwwwwwwwwwwwwwwwwwwwwwwwwwwwW
WWWWWWWWWWWWWWWWWWWWWWWWWWWWWWWWWWWWWWWWWWWWWWWWWWWWWWWWWWWWWWWWWWWWWWWWWWWWWWWWWWWWWWWWWWWWWWWWWWWWWWWWWWWWWWWWWWWWWWWWWWWWWWWWWWWWWWWWWWWWWWWWWWWWWWWWWWWWWWWWWWWWWWWWWWWWWWWWWWWWWWWWWWWWWWWWWWW