WWWWWWWWWWWWWWWWWWWWWWWWWWWWWWWWWWWWWWWWWWWWWWWWWWWWWWWWWWWWWWWWWWWWWWWWWWWWWWWWWWWWWWWWWWWWWWWWWWWWWWWWWWWWWWWWWWWWWWWWWWWWWWWWWWWWWWWWWWWWWWWWWWWWWWWWWWWWWWWWWWWWWWWWWWWWWWWWWWWWWWWWWWWWWWWWWWW
W...................E................WWWWWWWWWWWWWWwwwwwwwwwwwwwwwwwwwwwwwwwwwwwwwwwwwwwwwwwwwwwwwwwwwwwwwwwwwwwwwwwwwwwwwwwwwwwwwwwwwwwwwwwwwwwwwwwwwwwwwwwwwwwwwwwwwwwwwwwwwwwwwwwwwwwwwwwwwwwwwW
W.........E..................E........WWWWWWWWWWWWwwwwwwwwwwwwwwwwwwwwwwwwwwwwwwwwwwwwwwwwwwwwwwwwwwwwwwwwwwwwwwwwwwwwwwwwwwwwwwwwwwwwwwwwwwwwwwwwwwwwwwwwwwwwwwwwwwwwwwwwwwwwwwwwwwwwwwwwwwwwwwwwW
W.......WWWWWWWWWWWWWWWWWWWWWWWW.......WWWWWWWWWWWWWWWWWWWWWWWWWwwwwwwwwwwwwwWWWWWWWWWWWWWWWWWWWWWWWWWWWWWWWWWWWWWWWWWWWWWWWWWWWWWWWWWWWWWWWWWWWWWWWWWWwwwwwwwwwwwwwwwwwwwwwwwwwwwwwwwwwwwwwwwwwwwW
W.......WWWWWWWWWWWWWWWWWWWWWWWWW.............E................WWWWWWWWWWWWWWW........E..............................................E................WWWWWWWWWWWWWWWWWWWWWWWWWWWWWWWWWWWWWWWWWWWWW
Wp......WWWWWWWWWWWWWWWWWWWWWWWWWW......E.............E........................E.............M............MMM.......M...........E........M..............E......................E......E..E...E....W
W.......WWWWWWWWWWWWWWWWWWWWWWWWW.....E..............M......E.M........................WWWWWWWWWWWWWWWWWWWWWWWWWWWWWWWWW..............WWWWW..E...................E....E...........E..E.E..E.M..E..W
W.......WWWWWWWWWWWWWWWWWWWWWW..........M...E..WWWWWWWWWWWWWWWWW....E.MM................E.......E...E......E......E..E........E....WWWWWWWWWWWW.....E.....................E.........WWWWWWWWWWWWWWW
W.......WWWWWWWWWWWWWWWWWWWWW......WWWWWWWWWWWWMMMMMMMMMMMMMMMWWWWWWWWWWWWWW..............E....E..E.............E...........WWWWWWMMMMMMMMMWWWW..............E.....M......WWWWWWWWWWWWWWWMMMMMMMMMW
W...........wwwwwwwwwwwwww.......WWMMMMMMMMMMMMMMMMMMMMMMMMMMMMMMMMMMMMWWWWWWWWWWWWWWWW.....M.E..E....R...E....E....E...WWWWWWWWMMMMMMMMMMMMMMMMWWWWWWW....M....WWWWWWWWWWWWWWWWWWWMMMMMMMMMMMMMMMW
W.............wwwwwwwwwwwww.....WWMMMMMMMMMMMMMMMMMMMMMMMMMMMMMMMMMMMMMMMMMMMMMMMMMMWWWWWWWWWWWWWWWWWWWWWWWWWWWWWWWWWWWWWWMMMMMMMMMMMMMMMMMMMMMMMMMWWWWWWWWWWWWWWWWWWWWWWWWWWWWWWWMMMMMMMMMMMMMMMMW
W.......WWWWWWWWWWWWWWWWWWWWWWWWWMMMMMMMMMMMMMMMMMMMMMMMMMMMMMMMMMMMMMMMMMMMMMMMMMMMMMMMMMMMMMMMMMMMMMMMMMMMMMMMMMMMMMMMMMMMMMMMMMMMMMMMMMMMMMMMMMMMMMMMMMMMMMMMMMMMMMMMMMMMMMMMMMMMMMMMMMMMMMMMMMW
WWWWWWWWWWWWWWWWWWWWWWWWWWWWWWWWWWWWWWWWWWWWWWWWWWWWWWWWWWWWWWWWWWWWWWWWWWWWWWWWWWWWWWWWWWWWWWWWWWWWWWWWWWWWWWWWWWWWWWWWWWWWWWWWWWWWWWWWWWWWWWWWWWWWWWWWWWWWWWWWWWWWWWWWWWWWWWWWWWWWWWWWWWWWWWWWWWW